AK  Alsunga - Kuldīga
AS  Ainaži - Smiltene
AZ  Aizpute - Saldus
BK  Bolderaja II - Krievu sala
CK  Čiekurkalns - Rīga Krasta
CR  Cīruļi - Roja
DD  Daugavpils Pas. - Daugavpils Šķ.
DE  C.p. 191 km - C.p. 524 km
DK  C.p. 524 km - C.p. 401 km
DR  Dubeņi - Rucava
DS  C.p.387.km. - Daugavpils Šķ.
DV  Daudzeva - Viesīte
DX  C.p. 192 km - C.p. 1 km
DZ  B.p. 8 km - C.p. 383 km
ED  Eglaine-eksp. - Daugavpils Pas.
EG  C.p.5.km. - Grīva
GA  Gulbene - Valsts robeža (Ape)
GR  Glūda - Valsts robeža (Reņģe)
IV  Ieriķi - Valsts robeža (Vecumi)
JM  Jelgava - Valsts robeža (Meitene)
JN  Jēkabpils - Valsts robeža (Nereta)
JV  Jaunkalsnava - Veseta
KJ  Krustpils - Jēkabpils
KK  Kārsava-eksp. - Valsts robeža (Kurcums)
KL  Valsts robeža (Kazbari) - Liepāja
KP  Kursa - Pāvilosta
LA  Liepāja - Aizpute
LI  Lāčupe - Iļģuciems
LV  Liepāja - Ventspils
LZ  Lopdārzi - Zīlāni
MB  Meitene - Bauska
ML  Madona - Lubāna
PG  Pļaviņas - Gulbene
PK  Priekule - Valsts robeža (Kalēti)
PP  Pakalnieši - Kūdupe
PS  Pāle - Staicele
RK  B.p.223.km. - Rēzekne I
RL  Riga Pasazieru - Liepaja
RP  C.p.Kleperova - Rēzekne II
RR  Rēzekne II - Rezekne I
RV  Riga Pasazieru - Valsts robeža (Lugaži)
RZ  Riga Pasažieru - Valsts robeža (Zilupe)
SA  Siliņi - Aknīste
SE  Šķirotava J - Ērgļi
SR  Sita - Rēzekne
TR  Valdgale - Roja
TT  Tornakalns - Tukums II
VA  Ventspils I - Ventspils Austrumi
VD  Ventspils - Dundaga
VI  Ventspils - Indra-eksp.
VJ  Ventspils Jūras - Ventspils 23.pārm
VL  Lugaži - Valka
VM  Valdgale - Mērsrags
VN  Ventspils Nafta - Ventspils II
VR  Valka - Rūjiena
VS  Ventspils - Stende
VV  Valsts robeža (Valka) - Valka
ZD  Zasulauks - Daugavgrīva
ZI  Zemitāni - Valsts robeža (Ipiķi)
ZK  C.p. 3 km - Kundziņsala
ZS  Zemitani - Šķirotava J
ZV  Valsts robeža (Žuldiņi) - Valka


Missing

    Ropaži - Endzeliņmežs.  750mm.  Closed 1924
    AZ: Sieksāte - Saldus
    Valtaiķi - Laidi.  600mm.  Closed 1926.


Forest railways (600mm)

    Ogre - Laubere
    Inčukalns - Allaži
    Siliņi - Elkšņi
    Plintiņi - Raķukrogs

