AAJ   Åmål - Årjäng
ABK   Ängelsberg - Kärrgruvan
ABP   Älvsbyn - Piteå hamn
AGX   Ångebyn - Ångebyn 21
AHB   Ängelholm - Helsingborg
AHK   Ängelholm - Klippan
AKF   Avesta Krylbo - Frövi
AKK   Almedal - Karlskrona central
AKS   Älmhult - Kristianstad
ALE   Alvhem - Lilla Edet
AMD   Ånge - Ånge godsbangård - Moradal
ARN   Arlanda nedre - Arlanda norra
ARV   Avesta Krylbo - Rättvik
ASB   Älmhult - Sölvesborg
ASL   Askersund - Lerbäck
ASN   Askesta - Sandarna
ASO   Albano - Stockholms östra
ASR   Åkers styckebruk - Strängnäs
ASU   Åsen - Unnen
ASV   Ånge - Sundsvall
ATM   Åstorp - Mölle
AZG   Åmmeberg - Zinkgruvan
BBH   Bjuv - Billesholm
BBM   Brintbodarne - Malung
BBS   Björndalsbron - Skymnäs
BFG   Brattfors - Geijersdal
BFV   Bofors - Valåsen
BHK   Bånghammar - Kloten
BHL   Bjuv - Hyllinge
BHP   Boden central - Haparanda gräns
BHS   Barsebäcksham  - Sjöbo
BIL   Billesholm - Landskrona
BKV   Brogrenen - Kyrkviken
BLH   Byvalla - Långshyttan
BLK   Billeberga - Landskrona
BLU   Boden central - Luleå malmhamn
BNO   Bollnäs - Orsa
BOH   Bor norra - Ohs bruk
BOS   Bokskogen nedre - Bokskogen övre
BRG   Boden central - Riksgränsen gräns
BSA   Bjärka Säby - Åtvidaberg
BSF   Beted - Skillingsfors
BSH   Börringe - Smygehamn
BSL   Bräcke - Storlien gräns
BTD   Birsta - Johannedal växel
BTS   Bastuträsk - Skelleftehamns - Rönnskärsverken
BVB   Bollstabruk - Västeraspby
BVH   Bredviken - Haparanda
BYX   Blägda - Yxern
CLS   Charlottenlund - Skivarp
CRX   Kristianstad 114 - Kristianstad GBG
CTY   Citybanan Stockolm.
DBS   Dalby - Bjärsjölagård
DHB   Dagarn - Hultebo
DHN   Djursholms Ösby - Näsbypark
DLF   Daglösen - Filipstad
DMH   Dannemora - Hallstavik
DMX   Dannemora västra - Dannemora södra
DSN   Djursholms Ösby - Svalnäs
EBK   Emmaboda - Kalmar central
EKH   Enköping - Enköpings hamn
ELE   Ed - Le
ENO   Ervalla - Nora - Otterbäcken
EOB   Eksjö - Österbymo
ERH   Enköping - Runhällen
ESN   Eskilstuna södra - Eskilstuna norra
EYS   Eslöv - Ystad
FBJ   Falun central - Björbo
FFO   Flen - Flens övre
FGB   Falun central - Göteborg N
FGG   Fors - Gruvgården
FHT   Forsmo - Hoting
FKN   Falköpings central - Nässjö central
FKP   Frövi - Köping
FLJ   Flemingsberg - Järna
FLN   Fjärås - Lygnern
FLR   Falköpings central - Landeryd
FLS   Färlöv - Strö
FLU   Frövi - Ludvika
FNM   Fornåsa - Motala central
FOB   Färjestaden - Ottenby
FPB   Filipstad - Persberg
FSB   Färjestaden - Böda
FSG   Fredriksskans - Gävle godsbangård
FSH   Filipstad - Skoghall
FSL   Fryksta - Lyckan
FUG   Falköping - Uddagården
FVX   Frövi 312 - Frövi 311
FYV   Finspång - Yxviken
GAH   Göteborg Central - Ängelholm
GBM   Göteborg Central - Arlöv (- Malmö)
GBX   Gävle godsbangård - Gävle central 423
GFH   Göteborg Västgöta - Forshem
GFR   Gimo - Faringe
GGB   Gävle central - Gävle godsbangård - Strömsbro
GHT   Gårdsjö - Håkantorp
GJK   Gånghester - Jönköpings central
GKJ   Guttsta - Kohlswa Jernverk
GKS   Göteborg Kville - Göteborg Skandiahamnen
GKV   Gammelstad - Karlsvik
GLH   Gävle central - Gävle-Långharn
GMO   Gävle central - Mora central
GNX   Gävle N - Gävle central 423
GOD   Göringen - Dalfors
GSA   Säröbanans Göteborg - Särö Västerskog
GSS   Göteborg - Strömstad
GSV   Göteborg Skandiahamnen - Göteborg Volvo
GTB   Gyttorp - Bredsjö
GTV   Gällivare - Tingvallskulle
GVF   Gällivare - Vitåfors
GVO   Gävle central - Ockelbo
GVX   Gällivare 511 - Gällivare 503
HAF   Hillared - Axelfors
HAJ   Hällnäs - Arvidsjaur
HBF   Hallsberg - Frövi
HBM   Hallsberg - Mjölby
HBR   Helsingborg - Råå
HEL   Helsingborg - Eslöv
HFG   Hällefors - Gravendal
HFX   Åbydal - Hamrångefjärden
HHA   Hässleholm - Åhus hamn
HHR   Hässleholm - Ramlösa
HKB   Hallanda - Kättilsbyn
HMB   Harmånger - Bergsjö
HNS   Hamrångefjärden - Norrsundet
HNV   Hörken - Neva
HRS   Hallsbergs rangerbangård - Skymossen
HRT   Hestra - Reftele
HSL   Hästveda - Skepparslöv
HSM   Härnösand - Mörtsal växel
HST   Hyllie - Svågertorp
HSV   Halmstad - Vislanda
HUR   Husums norra - Rågön
HVB   Hudiksvall - Vattrångsby
HVV   Hå - Vallvik
HYH   Hörby - Höör
ISS   Igelboda - Solsidan
JAB   Järna - Åby södra
JBH   Jädersbruk - Hovsta
JGV   Jörn - Gällivare
JKV   Jönköping Ö - Vireda
JLV   Johannisberg - Ljungaverk
JMB   Jularbo - Månsbo
JSH   Jämtlands Sikås - Hammerdal
JVJ   Jenny - Växjö
JVR   Jönköpings central - Vaggeryd
KAS   Kummelby - Arkösund
KAX   Kattarp 521 - Kattarp 532
KBB   Kisstjärnsbäcken - Bastkärn
KBH   Kolbäck - Brattheden
KBK   Källby - Kinne Kleva
KBX   Kolbäck 118 - Kolbäck 116
KEL   Klippan - Eslöv
KFK   Kil - Fryksta
KFS   Kilafors - Söderhamn V
KGH   Kortfors - Grythyttan
KGK   Kärrgruvan - Klackberg
KHB   Kristinehamn - Brunflo
KHM   Katrineholms central - Malmö central
KHT   Klagshamn - Tygelsjö
KMB   Kalmar - Berga
KMT   Kalmar - Torsås
KMV   Kolmården - Virå
KNH   Kimstad - Norsholm
KPS   Kvillsfors - Pauliström
KRB   Klockrike - Borensberg
KRH   Knaby - Ramhäll
KRO   Karungi - Övertorneå
KSG   Kristianstads central - Gullberna
KSK   Kristianstad - Köpingebro
KSN   Karlberg - Stockholms norra
KTS   Kejsartorp - Svansbo
KUR   Köping - Källfallet
KVA   Koijuvaara - Aitik
KVB   Kullsveden - Bispberg
KVL   Karlshamn - Vislanda
KYK   Avesta Krylbo - Kärrgruvan
KYX   Kumla - Närkes Kvarntorp
LAX   Laxå 110 - Laxå 113
LBE   Långebro - Eslöv
LBM   Lessebo - Målerås
LCB   Laxå - Charlottenberg gränsen
LES   Liljeholmen - Enskede
LFB   Lindfors - Bosjön
LHF   Linköpings central - Hultsfred
LHL   Lund - Harlösa
LHM   Limhamn - Malmö V
LHP   Ljungbyholm - Påryd
LHV   Ljusdal - Hudiksvall
LKO   Linköping - Ödeshög
LKT   Lidköping - Tun
LLH   Lövlid - Holmsele hamn
LLV   Ljungaverks lastplats - Ljungaverk
LNF   Lernacken - Fosieby
LNS   Linghed - Norrsundet
LOX   Lockarp - Oxie
LRF   Limmared - Falkenberg
LRT   Linköping - Ringstorp
LTB   Landskrona - Trelleborg
LUB   Lund - Bjärred
LVL   Laxå - Västra Laxsjön
LYS   Smedberg - Lysekil
MAB   Mönsterås - Blomstermåla
MAD   Morastrand - Älvdalen
MBM   Munkedals bruk - Munkedals hamn
MFH   Mönsterås - Fagerhult
MFL   Mariefred - Läggesta
MGP   Malmö - Genarp
MGR   Mellerud - Gilserud
MGX   Malmö godsbangård - Östervärn
MHH   Mjölby - Hästholmens hamn
MKB   Morjärv - Karlsborgsbruk Norrbotten
MKS   Mellerud - Kornsjö gränsen
MLN   Malmö central - Lernacken
MLX   Mellerud triangelspår
MMB   Mönsterås - Mönsterås bruk
MMS   Moholm - Mariestad
MNX   Mora Noret - Mora Norets norra
MOV   Mellansel - Örnsköldsviks central
MRG   Malmö V - Rydsgård
MSH   Malmö - Simrishamn
MSN   Mellerud - Sunnanå
MTB   Malmö central - Trelleborg
MYS   Malmö V - Ystad
NAB   Nättraby hamn - Älmeboda
NFH   Nyhyttan - Finnshyttan
NHA   Nynäshamn - Älvsjö
NHS   Nässjö central - Halmstads central
NKB   Norberg - Klackberg
NKM   Norraryd - Kvarnamåla
NLB   Norrmon - Lövstabruk
NMH   Näs bruk - Morshyttan
NNB   Nässjo central - Nybro
NOH   Nässjö - Oskarshamn
NTB   Nordmark - Taberg
NTX   Nacksta 513 - Nacksta 511
NVM   Norrköpings östra - Valdemarsvik
NVV   Norsholm - Västervik
NYF   Nyfors 1 - Älvsbyn växel
NYX   Nyfors 2 - Nyfors 4
NXN   Nykroppa - Nykroppa 101
NXV   Nykroppa - Hornkullen
OBV   Olsfors - Bergsviken
ODM   Örbyhus - Dannemora
OHS   Oskarshamn - Sevedstorp
ORS   Örebro - Svartå
OSA   Ormaryd - Smålands Anneberg
OSB   Örebro - Skebäck
OSF   Orrskog - Söderfors
OST   Östersunds västra - Storuman
OUV   Orrskog - Untraverket
OVA   Ovansjö - Ånge godsbangård
OVG   Örnsköldsviks central - Gimmonäs
OXO   Oxmyran - Öreälv
OXV   Oxelösund - Valskog
OXX   Öxnered 124 - Öxnered 125
PBG   Persberg - Persbergs gruva
PBO   Pålsboda - Örebro södra
PBX   Malmö Persborg - Hindby
PEX   Peuravaara - Peuravaara 432
PHL   Peberholm riksgräns - Lernacken
PHM   Piteå - Haraholmen
PHT   Pershyttan övre - Pershyttan växel
PKI   Peuravaara - Kiruna malmbangård
PNK   Pålsboda - Norrköpings östra
RFS   Robertsfors - Sikeå hamn
RGH   Ropsten - Gåshaga brygga
RHB   Romakloster - Hablingbo
RHH   Ronehamn - Hemse
RHL   Riddarhyttan - Lerklockan
RIB   Rämshyttan - Idkerberget
RKB   Rekarne - Kolbäck
RKS   Romakloster - Slite
RLK   Ramlösa - Kävlinge
RNO   Roslags Näsby - Österskär
RNT   Rimbo - Norrtälje hamn
RNV   Risinge - Norrvällen
RPV   Råtsi - Peuravaara
RRH   Ronneby - Ronneby hamn
RSV   Råtsi - Svappavaara
RSX   Råtsi 401 - Råtsi 442
RUP   Rimbo - Uppsala Ö
SAM   Skavstaby - Arlanda central - Myrbacken
SAV   Skövde - Axvall
SBH   Sölvesborg - Hörviken
SBL   Slind - Boliden
SBT   Svensbro - Tidaholm
SDF   Striberg - Degerfors
SDR   Skälebol - Dals Rostock
SEB   Sjögränd - Edebäck
SET   Södertälje hamn - Eskilstuna central
SGM   Storå - Guldsmedshyttan
SHB   Stockholms central - Boden central
SHC   Södertälje hamn - Södertälje centrum
SHG   Sala - Hagaström
SHH   Stockholms östra - Hallstavik
SHL   Söderhamns västra - Locket
SHN   Skelleftehamns övre - Skelleftehamns nedre
SHV   Stockholm - Västerås norra
SHX   Söderhamns västra 20 - Söderhams västra 21
SKB   Skövde - Karlsborg
SLA   Stockholms Södra - Liljeholmen - Älvsjö
SLK   Stenstorp - Lidköping
SLT   Stocksund - Långängstorp
SLV   Spånga - Lövsta
SMB   Södertälje hamm - Mälarbaden
SMG   Silverhöjden - Mossgruvan
SML   Sävsjö - Målilla
SMX   Storuman 26 - Storuman 24
SNV   Spångenäs - Vimmerby
SOS   Sandbäck - Olofström
SSA   Storå - Stråssa
SSB   Slussen - Saltsjöbaden
SSH   Säby - Säbyholm
SSV   Stålboga - Skebokvarn
STD   Skara - Timmersdala
STH   Stenstorp - Hjo
STS   Södertälje syd övre - Mot Eskilstuna
SUS   Sundbyberg N - Ulvsundasjön
SVB   Stockholm - Vansbro
SVH   Sveg - Hede
SVT   Skönvik - Tunadal
SXT   Svågertorp - Lockarp 862
SXY   Svågertorp - Lockarp 860
TAA   Tollarp - Åhus
TBH   Tumleberg - Håkantorp
TBK   Torsås - Bergkvara
TBS   Tillberga - Sala
TBV   Tomteboda bangård - Värtan
TGB   Torsås - Gullberna
TGS   Torved - Gullspång
THB   Torup - Hyltebruk
THN   Trollhättan - Nossebro
TKP   Tillberga - Köping
TOX   Torup 101 - Torup 102
TRL   Triangeln - Ramlösa brunnspark öster
TSB   Tierp - Strömsberg
TSG   Torsås - Gullaboby
TSO   Tomelilla - S:t Olov
UEK   Uppsala norra – Enköping
UFK   Uggelfors - Krampen
UFS   Ulriksfors - Strömsund
USL   Uppsala - Sundsvall - Långsele
UVB   Uddevalla hamn - Bebgtsfors V
UVV   Uddevalla central - Varberg
VBD   Växjö - Bredåkra
VBK   Varberg - Kinnared
VBS   Vansbro - Särna
VBV   Visby - Burgsvik
VBY   Vimmerby - Ydrefors
VFB   Vellinge - Falsterbo
VHH   Veinge - Hässleholm
VHS   Vännäs - Holmsund
VHV   Visby - Hallvards
VJS   Vintjärn - Svartbäcken
VKB   Värnamo - Kärreberga
VLB   Visby - Lärbro
VLN   Voxna - Lobonäs
VMT   Vikmanshyttan - Turbo
VNX   Vännäs norra - Vännäs 409
VOV   Västeraspby - Örnsköldsvik
VRO   Värtan - Ropsten
VRV   Vattjom - Runsvik
VSB   Väderstad - Bränninge
VSH   Vallvik - Söderhamns västra
VTA   Vartofta - Åsarp
VTH   Vartofta - Tidaholm
VVX   Vallvik 6 - Ljusne bruk

# To do

      458 Malmö triangelspår

